*Snake
*20
*15
#R R R R R R R R R R R R R R R R R R R R
#L L L L L L L L L L L L L L L L L L L R
#L R R R R R R R R R R R R R R R R R L R
#L R L L L L L L L L L L L L L L L R L R
#L R L R R R R R R R R R R R R R L R L R
#L R L R L L L L L L L L L L L R L R L R
#L R L R L R R R R R R R R R L R L R L R
#L R L R L R L L L L L L L R L R L R L R
#L R L R L R L E R R R R R R L R L R L R
#L R L R L R L L L L L L L L L R L R L R
#L R L R L R R R R R R R R R R R L R L R
#L R L R L L L L L L L L L L L L L R L R
#L R L R R R R R R R R R R R R R R R L R
#L R L L L L L L L L L L L L L L L L L R
#L R R R R R R R R R R R R R R R R R R R

/



____________________________________

*   (1)Name
*   (2)Breite
*   (3)Hoehe
#   Feldtypen
/   Ende des Dokuments

I   InterpretFeld
C   CoverFeld
T   Titelfeld
E   Ereignisfeld
F   Faktfeld
X   Endfeld
L   Leeres Feld
R   RandomFeld
_________________________________

